0000000000000000000000000
0000000000000000000000000
0000000000000000000000000
0000000000000000000000000
0000001111110000000000000
0000000000000001111100000
0000000000000000000000000
0000001111110000000000000
0000000000000000000000000
0000000000000011110000000
0000000000000000000000000
0000011111100000000000000
0000000000000000000000000
0000000000000011111000000
0000000000000000000000000
0011111100000000000000000
0000000000000000000000000
0000000000000000000000000
1111111111111111111111111
